Aasjägerei_N	NEG
Gurkentruppe_N	NEG
Stinktier_N	NEG
runterrocken_N	NEG
Halbdackel_N	NEG
Schimpfwort_N	NEG
Schundroman_N	NEG
Putzfimmel_N	NEG
Scheißhaus_N	NEG
Dummkopf_N	NEG
Förderschullehrer_N	NEU
Schlappschwanz_N	NEG
Schweinebacke_N	NEG
Waldschrat_N	NEG
Hasenscharte_N	NEG
Betonklotz_N	NEG
Stoßdame_N	NEG
Fußhupe_N	NEG
Katzenmusik_N	NEG
Idiotentest_N	NEG
Arschfick_N	NEG
Fliegenfänger_N	NEG
Gesichtselfmeter_N	NEG
Kostgänger_N	NEG
Vulgärwort_N	NEU
Blütensekt_N	NEU
Osterhasenpädagogik_N	NEG
Turbokapitalismus_N	NEG
Wildsau_N	NEU
Sauhaufen_N	NEG
Eichelkäse_N	NEG
Kühltruhe_N	NEU
Politklasse_N	NEG
Saufabend_N	NEG
Hurrapatriotismus_N	NEG
Kraftausdruck_N	NEG
Kirchturmpolitik_N	NEG
Zedernholzgeruch_N	NEU
Ständerwand_N	NEU
Hirschwurz_N	NEU
Flachwichser_N	NEG
Schwanzlutscher_N	NEG
Zappelphilipp_N	NEG
Faustball_N	NEU
Nervenplastik_N	NEU
Maultrommel_N	NEU
Sargnagel_N	NEG
Hosenrohr_N	NEU
Gschaftlhuber_N	NEG
Retortenband_N	NEG
Langweiler_N	NEG
altbacken_N	NEG
Sauhund_N	NEG
Spielverderber_N	NEG
Kraftwort_N	NEG
Ladenschwengel_N	NEG
Aasgeier_N	NEG
Federball_N	NEU
Bierdimpfel_N	NEG
rechtspopulistisch_N	NEG
Diebesbande_N	NEG
Medienhure_N	NEG
Scheißhaufen_N	NEG
Hundescheiße_N	NEG
abspritzen_N	NEU
Gummiparagraph_N	NEG
Sesselpfurzer_N	NEG
Achtgroschenjunge_N	NEG
Sonderschullehrer_N	NEU
Gesichtsbaracke_N	NEG
Querkopf_N	NEG
Hackfresse_N	NEG
großkotzig_A	NEG
Waschstraße_N	NEU
faustficken_N	NEU
Seelenstriptease_N	NEG
Schurkenstaat_N	NEG
Zigeunersoße_N	NEU
Possenspiel_N	NEG
Gefrierschrank_N	NEU
Auschwitzlüge_N	NEG
Wohlstandsmüll_N	NEG
Arschgesicht_N	NEG
Drecksau_N	NEG
Kühlschrank_N	NEU
neumodisch_N	NEG
Blödmann_N	NEG
aalglatt_N	NEG
Pissnelke_N	NEG
Kinderbuchautor_N	NEU
Kühlschiff_N	NEU
Lügenpresse_N	NEG
Speckdäne_N	NEG
Luxusproblem_N	NEG
Russenliebchen_N	NEG
Konservierungsmittel_N	NEU
Spießbürger_N	NEG
Schafskopf_N	NEG
Pixelschubser_N	NEG
Wirtschaftsflüchtling_N	NEG
Fresssack_N	NEG
Saftladen_N	NEG
Bohrinsel_N	NEU
Radfahrer_N	NEU
Aberglaube_N	NEG
Spielwiese_N	POS
Winkeljournalist_N	NEG
Sonderbilanz_N	NEU
Kotzbrocken_N	NEG
Schweinefraß_N	NEG
Kraftmeier_N	NEG
Rennboot_N	NEU
Schaulust_N	NEG
Betonkopf_N	NEG
Reithose_N	NEU
Weinpanscher_N	NEG
Gierschlund_N	NEG
Ostwestfalen_N	NEU
Fotzenlecker_N	NEG
Zeitungsente_N	NEG
Arschloch_N	NEG
Krämerseele_N	NEG
Armeleutegeruch_N	NEG
Salonkommunismus_N	NEG
talentfrei_N	NEG
Abschaum_N	NEG
Lausebengel_N	NEG
Landei_N	NEG
notgeil_N	NEG
Eigenbrötler_N	NEG
Straßenkind_N	NEG
Dreiständerbau_N	NEU
Vollidiot_N	NEG
Spitzname_N	NEU
Schmierentheater_N	NEG
Erbsenzähler_N	NEG
Tratschtante_N	NEG
Hornochse_N	NEG
Einheitskleidung_N	NEG
Dunkeldeutschland_N	NEG
Pseudowissenschaft_N	NEG
Trinkgelage_N	NEG
Kuhdorf_N	NEG
Arschbacke_N	NEG
Fickloch_N	NEG
Dreieckmarke_N	NEU
Halbwissen_N	NEG
Hutfahrer_N	NEG
Affenarsch_N	NEG
Wacholderbranntwein_N	NEU
Spinatwachtel_N	NEG
Fettwanst_N	NEG
Schmähwort_N	NEG
Tattergreis_N	NEG
Neudeutsch_N	NEG
Sprachrevitalisierung_N	POS
Grüßaugust_N	NEG
Hängetitte_N	NEG
Brüllwürfel_N	NEG
Quotenfrau_N	NEG
Falkenberg_N	NEU
Irrenanstalt_N	NEG
Hasstirade_N	NEG
Medizinball_N	NEU
Gutmensch_N	NEG
Dudelfunk_N	NEG
Schmähschrift_N	NEG
bolschewistisch_N	NEG
Kuschelkurs_N	NEG
halbstark_N	NEG
Giftzwerg_N	NEG
Hofschranze_N	NEG
Wichsvorlage_N	NEG
Sauklaue_N	NEG
Galgenvogel_N	NEG
Schreckschraube_N	NEG
abbremsen_N	NEG
Drachenboot_N	NEU
Warmduscher_N	NEG
Revolverpresse_N	NEG
Neuhumanismus_N	NEU
Drecksack_N	NEG
Arschkriecher_N	NEG
Rothaut_N	NEG
Aberglauben_N	NEG
Bierschiss_N	NEG
Pantoffelheld_N	NEG
Heuschrecke_N	NEG
Saftschubser_N	NEG
Kopftuchmädchen_N	NEG
Knackarsch_N	POS
Arschgeige_N	NEG
Hühnerkacke_N	NEG
Käseblatt_N	NEG
Boulevardpresse_N	NEG
Aasgestank_N	NEG
Mauerblümchen_N	NEG
Regenblase_N	NEU
quittegelb_N	NEG
Schildbürger_N	NEG
