Abnehmfilm	N	(abnehmen_V (ab_x) (nehmen_V)) (Film_N)
Adressauflösungsdienst	N	(Adressauflösung (Adresse_N) (Auflösung_N (auflösen_V (auf_x) (lösen_V)) (ung_x))) (s_x) (Dienst_N)
Adress-Dürre	N	(Adresse_N) (Dürre_N)
Aerobicfetzen	N	(Aerobic_N) (Fetzen_N)
Akustikschock	N	(Akustik_N) (Schock_N)
Altersegoist	N	(Alter_N) (s_x) (Egoist_N)
Ankertaumine	N	(Anker_N) (Tau_N) (Mine_N)
Anwesenheitsaffäre	N	(Anwesenheit_N (anwesen_R) (heit_x)) (s_x) (Affäre_N)
Arzneimitteltherapiesicherheit	N	(Arzneimittel_N (Arznei_N) (Mittel_N)) (Therapiesicherheit_N (Therapie_N) (Sicherheit_N))
Aufstellungschoreograph	N	(Aufstellung_N (aufstellen_V (auf_P) (stellen_V)) (ung_x)) (s_x) (Choreograph_N )
Auktionsfernsehkanal	N	(Auktion_N) (s_x) (Fernsehkanal_N (Fernsehen_N) (Kanal_N))
Autotröte	N	(Auto_N) (Tröte_N)
Babymobil	N	(Baby_N) (Mobil_R)
Badehosen-Erklär-Schild	N	(Badehose_N) (n_x) (erklären_V) (Schild_N)
Batteriewechselnetz	N	(Batteriewechsel_N (Batterie_N) (Wechsel_N)) (Netz_N)
Behindertenkarte	N	(Behinderte_N) (n_x) (Karte_N)
bekleidungsoptional	A	(Bekleidung_N (bekleiden_V) (ung_x)) (s_x) (optional_A)
Besäufnisanstalt	N	(Besäufnis_N (besaufen_V) (nis_x)) (Anstalt_N)
Bespitzelungsgerät	N	(Bespitzelung_N (bespitzeln_V (be_x) (spitzeln_V)) (ung_x)) (s_x) (Gerät)
Beteiligungsmakler	N	(Beteiligung_N) (s_x)(Makler_N)
Billig-Prepaid-Telefon	N	(billig_A) (Prepaidtelefon_N (Prepaid_R) (Telefon_N))
binnenfamiliär	A	(binnen_P) (familiär_A (Familie_N) (är_x))
Biosteak	N	(Bio_R) (Steak_N)
Bootsmigrant	N	(Boot_N) (s_x) (Migrant_N)
Bremskraftbegrenzer	N	(Bremskraft_N (bremsen_V) (Kraft_N)) (Begrenzer_N (begrenzen_V (be_x) (grenzen_V)) (er_x) )
Brotboutique	N	(Brot_N) (Boutique_N)
Bürgerflatrate	N	(Bürger_N) (Flatrate_N)
Computerverschalung	N	(Computer_N) (Verschalung_N (verschalen_V) (ung_x))
Cyberstelle	N	(Cyber_F) (Stelle_N)
Dauerporno	N	(Dauer_N) (Porno_N)
Demokratieimperialismus	N	(Demokratie_N) (Imperialismus_N)
Demokratiemeile	N	(Demokratie_N) (Meile_N)
Dienstdrohne	N	(Dienst_N) (Drohne_N)
Egoaufbauprogramm	N	(Ego_N) (Aufbauprogramm_N (Aufbau_N) (Programm_N))
Eitelkeitsfingerschmuck	N	(Eitelkeit_N) (s_x) (Fingerschmuck_N (Finger_N) (Schmuck_N))
Emigrationsdienst	N	(Emigration_N) (s_x) (Dienst_N)
Ereignisdemokratie	N	(Ereignis_N) (Demokratie_N)
Essensverwahrlosung	N	(Essen_N) (s_x) (Verwahrlosung_N (verwahrlosen_V) (ung_x))
Fernschussfestival	N	(Fernschuss_N (fern_A) (Schuss_N)) (Festival_N)
Feuerzeugnehmer	N	(Feuerzeug_N (Feuer_N) (Zeug_N)) (nehmen_V) (er_x)
Flugzeug-Landesystem	N	(*Flugzeug_N* (*Flug_N* fliegen_V) (Zeug_N)) (Landesystem_N (Lande_N) (System_N))
Fuzz-Folk	N	(Fuzz_R) (Folk_N)
Geldfundamentalist	N	(Geld_N) (Fundamentalist (fundamental_A (Fundament_N) (al_x)) (ist_N))
Geruchsvorurteil	N	(Geruch_N) (s_x) (Vorurteil_N (vor_P) (Urteil_N))
Gesichtserkennungs-Programm	N	(Gesichtserkennung_N (Gesicht_N) (s_x) (Erkennung_N (erkennen_V) (ung_x) ) ) (s_x) (Programm_N)
GPRS-Tarif	N	(GPRS_N) (Tarif_N)
Hausmeisterargument	N	(Hausmeister_N (Haus_N) (Meister_N)) (Argument_N)
Helldunkel-Dramaturgie	N	(hell_A) (dunkel_A) (Dramaturgie_N)
Hostingvertrag	N	(Hosting_N) (Vertrag_N)
Hybrid-Kultur	N	(Hybrid_N) (Kultur_N)
Identitäts-Workshop	N	(Identität_N) (s_x) (Workshop_N)
Infotransfer	N	(Info_N) (Transfer_N)
Inhaftierungstabelle	N	(Inhaftierung_N (inhaftieren_V (in_x) (Haft_N) (ier_x)) (ung_x)) (s_x) (Tabelle_N)
Klingelton-Superstar	N	(Klingelton_N (klingeln_V) (Ton_N)) (Superstar_N (super_x) (Star_N) )
Kohäsions-Index	N	(Kohäsion_N) (s_x) (Index_N)
Konservenansage	N	(Konserve_N) (n_x) (Ansage_N (ansagen_V (an_P) (sagen_V)) (e_x))
Körper-Check	N	(Körper_N) (Check_N)
Kreditklima	N	(Kredit_N) (Klima_N)
kurvenhungrig	A	(Kurve_N) (n_x) (hungrig_A)
Lackschuhfraktion	N	(Lackschuh_N (Lack_N) (Schuh_N)) (Fraktion_N)
Land-Know-how	N	(Land_N) (Know-how_N)
Lebensversicherungshandel	N	(Lebensversicherung_N (Leben_N) (s_x) (Versicherung_N (versichern_V (ver_x) (sichern_V)) (ung_x))) (s_y) (Handel_N)
Lernpartnerbörse	N	(Lernpartner_N (lernen_V) (Partner_N)) (Börse_N)
Luftschnorrer	N	(Luft_N) (Schnorrer_N (schnorren_V) (er_x))
Mediencampus	N	(Medien_N) (Campus_N)
menschenüberdrüssig	A	(Mensch_N) (en_x) (überdrüssig_A (Überdruss_N) (ig_x))
minutenscharf	A	(Minute_N) (n_x) (scharf_A)
Modulverordnung	N	(Modul_N) (Verordnung_N (*verordnen_V* (ver_x) (ordnen_V)) (ung_x))
Motivationsschlipsträger	N	(Motivation_N) (s_x) (Schlipsträger_N (Schlips_N) (tragen_V) (er_x))
Multibewerbungsmethode	N	(Multibewerbung_n (Multi_R) (Bewerbung_N)) (s_x) (Methode_N)
multisystemisch	A	(multi_x) (systemisch_A (System_N) (isch_x))
Nebelmittelwurfanlage	N	(Nebelmittel_N (Nebel_N) (Mittel_N)) (Wurfanlage_N (Wurf_N) (Anlage_N))
Negativnebenwirkungsstärke	N	(Negativnebenwirkung_N (negativ_A) (Nebenwirkung_N (neben_P) (Wirkung_N (wirken_V) (ung_x) ) )) (s_x) (Stärke_N)
Onlinemafia	N	(online_A) (Mafia_N)
pathoslüstern	A	(Pathos_N) (lüstern_A)
Pay-Sektor	N	(Pay_R) (Sektor_N)
Pointenkater	N	(Pointen_N) (Kater_N)
Psychomotorikhalle	N	(Psychomotorik_N (Psyche_N) (Motorik_N) ) (Halle_N)
quantenoptimiert	A	(Quanten_F) (optimiert_A)
Querfrontler	N	(quer_B) (Frontler_N (Front_N) (ler_x))
Quotengrabscher	N	(Quote_N) (n_x) (Grabscher_N (grabschen_V) (er_x))
Radarchip	N	(Radar_N) (Chip_N)
Rechtsstaatimitat	N	(Rechtsstaat_N (Recht_N) (s_x) (Staat_N)) (Imitat_N)
Rucksackkurs	N	(Rucksack_N) (Kurs_N)
Schnelllade-Infrastruktur	N	(Schnelllade_n (schnell_A) (laden_V) (e_x)) (Infrastruktur_N)
Schreibtischbolide	N	(Schreibtisch_N (schreiben_V) (Tisch_N)) (Bolide_N)
Schubladenwort	N	(Schublade_N) (n_x) (Wort_N)
Shakespearekinder	N	(Shakespeare_N) (Kind_N) (er_x)
Staufach	N	(stauen_V) (Fach_N)
suchmaschinell	A	(suchen_V) (maschinell (Maschine_N) (ell_x))
Suchrealität	N	(suchen_V) (Realität_N)
Textgespräch	N	(Text_N) (Gespräch_N)
Turbomethode	N	(Turbo_R) (Methode_N)
Urlaubsoutfit	N	(Urlaub_N) (s_x) (Outfit_N)
Velogreis	N	(Velo_N) (Greis_N)
Vorbehaltnetz	N	(Vorbehalt_N) (Netz_N)
Wärmeschublade	N	(Wärme_N) (Schublade_N)
Wirtschaftswunderraffke	N	(Wirtschaftswunder_N (Wirtschaft_N  (Wirt_N) (schaft_x)) (s_x) (Wunder_N)) (Raffke_N)
Yakitori-Imbiss	N	(Yakitori_N) (Imbiss_N)
Zivilpflicht	N	(zivil_A) (Pflicht_N)
