Abnehmfilm_N	NEU
Adressauflösungsdienst_N	NEU
Adress-Dürre_N	NEG
Aerobicfetzen_N	NEG
Akustikschock_N	NEG
Altersegoist_N	NEG
Ankertaumine_N	NEG
Anwesenheitsaffäre_N	NEG
Arzneimitteltherapiesicherheit_N	POS
Aufstellungschoreograph_N	NEU
Auktionsfernsehkanal_N	NEU
Autotröte_N	NEG
Babymobil_N	NEU
Badehosen-Erklär-Schild_N	NEU
Batteriewechselnetz_N	NEU
Behindertenkarte_N	NEU
bekleidungsoptional_N	POS
Besäufnisanstalt_N	NEG
Bespitzelungsgerät_N	NEG
Beteiligungsmakler_N	NEU
Billig-Prepaid-Telefon_N	NEG
binnenfamiliär_N	NEU
Biosteak_N	NEU
Bootsmigrant_N	NEU
Bremskraftbegrenzer_N	NEU
Brotboutique_N	NEG
Bürgerflatrate_N	NEU
Computerverschalung_N	NEU
Cyberstelle_N	NEU
Dauerporno_N	NEG
Demokratieimperialismus_N	NEG
Demokratiemeile_N	POS
Dienstdrohne_N	NEU
Egoaufbauprogramm_N	NEG
Eitelkeitsfingerschmuck_N	NEG
Emigrationsdienst_N	NEU
Ereignisdemokratie_N	NEG
Essensverwahrlosung_N	NEG
Fernschussfestival_N	NEG
Feuerzeugnehmer_N	NEU
Flugzeug-Landesystem_N	NEU
Fuzz-Folk_N	NEU
Geldfundamentalist_N	NEG
Geruchsvorurteil_N	NEG
Gesichtserkennungs-Programm_N	NEU
GPRS-Tarif_N	NEU
Hausmeisterargument_N	NEG
Helldunkel-Dramaturgie_N	NEU
Hostingvertrag_N	NEU
Hybrid-Kultur_N	NEU
Identitäts-Workshop_N	NEU
Infotransfer_N	NEU
Inhaftierungstabelle_N	NEU
Klingelton-Superstar_N	POS
Kohäsions-Index_N	NEU
Konservenansage_N	NEG
Körper-Check_N	NEU
Kreditklima_N	NEU
kurvenhungrig_N	POS
Lackschuhfraktion_N	NEG
Land-Know-how_N	POS
Lebensversicherungshandel_N	NEU
Lernpartnerbörse_N	NEU
Luftschnorrer_N	NEG
Mediencampus_N	NEU
menschenüberdrüssig_N	NEG
minutenscharf_N	POS
Modulverordnung_N	NEU
Motivationsschlipsträger_N	NEG
Multibewerbungsmethode_N	NEU
multisystemisch_N	NEG
Nebelmittelwurfanlage_N	NEU
Negativnebenwirkungsstärke	NEU
Onlinemafia_N	NEG
pathoslüstern_N	NEG
Pay-Sektor_N	NEU
Pointenkater_N	NEG
Psychomotorikhalle_N	NEU
quantenoptimiert_N	POS
Querfrontler_N	NEG
Quotengrabscher_N	NEG
Radarchip_N	NEU
Rechtsstaatimitat_N	NEG
Rucksackkurs_N	NEU
Schnelllade-Infrastruktur_N	NEU
Schreibtischbolide_N	NEG
Schubladenwort_N	NEG
Shakespearekinder_N	NEU
Staufach_N	NEU
suchmaschinell_N	NEU
Suchrealität_N	NEU
Textgespräch_N	NEU
Turbomethode_N	POS
Urlaubsoutfit_N	NEU
Velogreis_N	NEG
Vorbehaltnetz_N	NEU
Wärmeschublade_N	NEU
Wirtschaftswunderraffke_N	NEG
Yakitori-Imbiss_N	NEU
Zivilpflicht_N	NEU
